30 seconds=30 Sekunden
1 minute=1 Minute
2 minutes=2 Minuten
5 minutes=5 Minuten
10 minutes=10 Minuten
30 minutes=30 Minuten
1 hour=1 Stunde
2 hours=2 Stunden
Above=Über
Array must be Started to view disk stats=Das Array muss **gestartet** sein, um Datenträgerstatistiken anzuzeigen
Array must be Started to view system stats=Das Array muss **gestartet** sein, um Systemstatistiken anzuzeigen
Available for Data=Verfügbar für Daten
Below=Unter
CPU Load=CPU-Last
Disk Usage=Datenträgernutzung
disks=Datenträger
High on Usage=Hoher Nutzungsgrad
Last day=Letzter Tag
Last 2 days=Die letzten 2 Tage
Last 3 days=Die letzten 3 Tage
Last week=Letzte Woche
Last 2 weeks=Die letzten 2 Wochen
Last 3 weeks=Die letzten 3 Wochen
Last month=Letzter Monat
Low on Space=Wenig Speicherplatz
Normal Usage=Normaler Nutzungsgrad
Real-time=Echtzeit
Since start=Seit dem Start
Storage=Speicher
Total Array Size=Gesamtgröße des Arrays
Total Space Used=Verwendeter Speicherplatz insgesamt
Used for Parity=Für Parität verwendet
utilization in percentage=Auslastung in Prozent
