A format is NEVER part of a data recovery or disk rebuild process and if done in such circumstances will normally lead to loss of all data on the disks being formatted=Eine Formatierung ist ** NIE ** Teil einer Datenwiederherstellung oder Datenträger wiederherstellung, sollte dies unter solchen Umständen geschehen gehen die Daten auf dem zu Formatierenden Laufwerk verloren
Aborted=Abgebrochen
Action=Aktion
Add Pool=Pool hinzufügen
Add=Hinzufügen
All existing data on this device will be OVERWRITTEN when array is Started=Alle vorhandenen Daten auf dem Datenträger werden ÜBERSCHRIEBEN wenn das Array gestartet wird
Array Devices=Array-Datenträger
Array of %s devices=Array aus %s Datenträgern
Array Operation=Array-Aktionen
Attribute Name=Attributname
Attributes not available=Attribute nicht verfügbar
Attributes=Attribute
auto=auto
Autotrim=Autotrim
Balance Status=Balance Status
Balance=Balance
Blacklisted=Blacklisted
Boot Device=Boot-Datenträger
Boot system in UEFI mode=Boote System im UEFI-Modus
btrfs balance status=btrfs Balance Status
btrfs check status=btrfs Check-Status
btrfs filesystem df=btrfs-Dateisystem
BTRFS operation is running=BTRFS-Operation läuft
btrfs scrub status=btrfs-Überprüfungsstatus
Canceled=Abgebrochen
Cannot contact key-server Please check your=Schlüsselserver kann nicht erreicht werden. Bitte prüfe deine
Capabilities not available=Funktionen nicht verfügbar
Capabilities=Funktionen
Check Filesystem Status=Dateisystem-Status überprüfen
Clear Stats=Statistiken löschen
Clearing in progress=Löschen läuft
Click on FLASH above this message=Klicke auf **FLASH** über dieser Nachricht
Click to spin down device=Klicken zum Herunterfahren des Datenträgers
Click to spin up device=Klicken zum Starten des Datenträgers
Comments=Kommentare
complete=Vollständig
Completed without error=Ohne Fehler abgeschlossen
completed=Abgeschlossen
Compression=Komprimierung
Configuration valid=Konfiguration in Ordnung
Convert to raid0 mode=Zu raid0-Modus konvertieren
Convert to raid1 mode=Zu raid1-Modus konvertieren
Convert to raid10 mode=Zu raid10-Modus konvertieren
Convert to raid1c3 mode=Zu Raid1c3-Modus konvertieren
Convert to raid1c4 mode=Zu Raid1c4-Modus konvertieren
Convert to raid5 mode see help=Zu raid5-Modus konvertieren, siehe Hilfe
Convert to raid6 mode see help=Zu raid6-Modus konvertieren, siehe Hilfe
Convert to single mode=Zu Single-Modus konvertieren
Copying=Kopiere
corrected=Korrigiert
Create an empty file system on the disks shown as Unmountable discarding all data currently on the disks and update parity to reflect this=Leeres Dateisystem erstellen und alle Daten löschen auf Datenträgern die als nicht einhängbar angezeigt werden und Parität aktualisieren.
creating Flash backup zip file this may take several minutes=Erstelle ZIP-Datei der Flash-Sicherung (dies kann einige Minuten dauern)
Creating Flash backup=Erstelle Flash-Sicherung
Creation error=Erstellungsfehler
Critical disk temperature threshold=Kritischer Grenzwert für Datenträgertemperaturwert
Critical disk utilization threshold=Kritischer Grenzwert für Datenträgerauslastung
Current operation %s on %s=Aktuelle Aufgabe %s auf **%s**
Current position=Aktuelle Position
Custom attributes use comma to separate numbers=Benutzerdefinierte Attribute (durch Komma getrennte Zahlen)
Data-Rebuild in progress=Datenwiederherstellung läuft
Date of purchase=Kaufdatum
Date=Datum
Delete Pool=Lösche Pool
detected=Erkannt
Device encrypted and unlocked=Datenträger verschlüsselt und entsperrt
Device encrypted=Datenträger verschlüsselt
Device is part of a pool=Datenträger ist Teil eines Pools
Device locked unknown error=Datenträger gesperrt: Unbekannter Fehler
Device locked wrong encryption key=Datenträger gesperrt: Falscher Verschlüsselungsschlüssel
Device to be encrypted=Datenträger zu verschlüsseln
Disable Spin down delay to run a SMART extended self-test=**Verzögerung beim Herunterfahren** deaktivieren, um einen erweiterten SMART-Test durchzuführen
Disk in parity slot is not biggest=Paritätsdatenträger ist nicht der Größte
Disk Log Information=Datenträgerprotokoll
Disk-Clear in progress=Datenträgerlöschung läuft
Do not use reserved names=Keine reservierten Namen benutzen
Do not use user share names=Keine Benutzerfreigabe-Namen benutzen
Download SMART report=Download SMART Bericht
Dual parity valid requires ALL disks in their original slots=*Doppelte Parität* erfordert **ALLE** Datenträger in den ursprünglichen Slots
Elapsed time=Verstrichene Zeit
Enable user share assignment=Zuweisung von Benutzerfreigaben aktivieren
encrypted=verschlüsselt
Encryption input=Verschlüsselungseingabe
Encryption status=Verschlüsselungsstatus
enter disk index and device name as applicable to your controller=Gebe den Datenträger-Index und den Gerätenamen ein, die für deinen Controller gelten.
Enter new key=Neuen Schlüssel eingeben
Erase Device Content=Lösche Datenträger Inhalt
Errors occurred - Check SMART report=Fehler - SMART Bericht Prüfen
Estimated finish=Geschätzte Fertigstellung
Estimated speed=Geschätzte Geschwindigkeit
Existing content is permanently lost=Existierende Daten werden unwiderruflich gelöscht
Failed=Fehlgeschlagen
Feature=Funktion
File system status=Dateisystemstatus
File system type=Dateisystemtyp
Finding %s error=**%s** Fehler gefunden
Finding %s errors=**%s** Fehler gefunden
Flag=Markieren
Flash backup=Flash-Sicherung
Flash device is set as public share=Flashdatenträger ist öffentlich freigegeben
Flash Device Settings=Flashdatenträger-Einstellungen
Format Unmountable disks=Formatiere nicht einhängbare Datenträger
Formatting=Formatiere
formatting=formatiere
Free=Frei
FS=FS
Global Configuration=Globale Konfiguration
Hide=Verstecken
Identification=Identifikation
Identity is not available=Identität ist nicht verfügbar
Identity=Identität
if checked, Start array but do not mount disks=Wenn ausgewählt, starte Array ohne Datenträger zu einzuhängen
If you are adding a new disk or replacing a disabled disk, try Parity-Swap=Falls ein neuer Datenträger hinzugefügt oder ein defekter ersetzt wird, bitte Parity-Swap versuchen
Incorrect confirmation=Falsche Bestätigung
Information=Information
Insufficient free disk space available=Nicht genügend freier Speicherplatz vorhanden
Interrupted=Unterbrochen
Invalid configuration=Konfiguration ungültig
invalid device=Ungültiges Gerät
invalid devices=Ungültige Geräte
Invalid expansion=Ungültige Erweiterung
Invalid pool name=Ungültiger Poolname
Invalid, missing or expired=Ungültig, fehlend oder abgelaufen
is only available when array is Started in Maintenance mode=nur verfügbar wenn das Array im **Wartungsmodus** gestartet wird
is only available when array is Started=nur verfügbar wenn Array gestartet ist
Keyfile=Lizenz-Datei
Last check completed on %s=Letzte vollständige Prüfung am **%s**
Last check incomplete on %s=Letzte nicht vollständige Prüfung am **%s**
Last checked on %s=Letzte Prüfung am **%s**
Last SMART test result=Letztes SMART Prüfergebnis
Maintenance mode=Wartungsmodus
Maintenance Mode=Wartungsmodus
Maintenance=Wartung
Manufacturing date=Herstellungsdatum
Menu View=Menüansicht
Minimum free space=Minimaler freier Speicher
mirror=spiegeln
Missing Cache disk=Fehlender Cache Datenträger
Missing disk=Fehlender Datenträger
Missing key=Fehlender Schlüssel
Missing=Fehlend
Mounted=Eingehängt
Mover is running=Mover läuft
network settings=Netzwerkeinstellungen
New data disks detected=Neue Datenlaufwerke erkannt
next device=Nächstes Gerät
No array data disks have been assigned=Keine Datenlaufwerke dem Array zugeordnet
No data disks=Keine Datenlaufwerke
no devices=Keine Geräte
No parity check history present=Kein Paritätsprüfungsverlauf vorhanden
No self-tests logged on this disk=Keine Selbsttests auf Datenträger gefunden
Not installed=Nicht installiert
Not present=Nicht vorhanden
OK=OK
Once copy completes, the array may be Started, to initiate Data-Rebuild of the disabled disk=Nach Abschluss des Kopiervorgangs wird das Array gestartet, um die Datenwiederherstellung des deaktivierten Datenträgers zu veranlassen
operation=Aufgabe
Options see Help=Optionen (siehe Hilfe)
Otherwise use the keyfile method for UTF8 input=Andernfalls benutze die **keyfile** Methode für UTF8 Eingabe
Parity disks content will be overwritten=Der Inhalt von *Paritäts* Datenträgern wird überschrieben
Parity is already valid=Parität ist bereits gültig
Parity Operation History=Paritätsvorgang-Verlauf
Parity operation is running=Paritätsvorgang läuft
Parity valid requires ALL disks to have their original content=Für eine *gültige Parität* müssen **ALLE** Datenträger ihren ursprünglichen Inhalt haben
Parity-Check in progress=Paritätsprüfung läuft
ParityRead-Check History=Parität/Lese-Prüfungsverlauf
Parity-Sync in progress=Paritäts-Synchronisierung läuft
Parity-SyncData-Rebuild in progress=Parität-Sync/Datenwiederherstellung läuft
Partition format=Partitionsformat
Partition size=Partitonsgröße
Passed=Bestanden
Passphrase=Verschlüsselungspasswort
Perform full balance=Vollständigen Balance ausführen
Permit UEFI boot mode=Erlaube UEFI Boot
Please change share SMB security=Bitte SMB Sicherheitseinstellungen ändern
Please check your system settings to support UEFI boot mode=Bitte Systemeinstellung Prüfen um UEFI Boot zu aktivieren
Please try again=Bitte erneut versuchen
Pool Devices=Pool-Datenträger
Pool name already exists=Poolname existiert bereits
Pool of %s devices=Pool aus %s Datenträgern
Pool Status=Pool-Status
Preclear in progress=Preclear läuft
previous device=Vorheriges Gerät
Printable Characters Only=Nur druckbare Zeichen
Proceed to start=Zum Start fortfahren
raid0=raid0
raid1=raid1
raid10=raid10
raid1c3=raid1c3
raid1c4=raid1c4
raid5=raid5
raid6=raid6
raidz=raidz
raidz2=raidz2
raidz3=raidz3
Raw Value=Rohwert
Raw View=Rohansicht
Read-Check in progress=Lese-Check läuft
Read errors corrected=Korrigierte Lesefehler
Read errors detected=Korrigierte Schreibfehler
Reading=Messwert
Reboot in safe mode=Neustart im abgesicherten Modus
Registration Key Manager=Lizenzschlüssel-Verwaltung
registration key=Lizenzschlüssel
ReiserFS is deprecated, please use another file system=ReiserFS ist veraltet, bitte benutzen Sie ein anderes Dateisystem
reiserfsck status=reiserfsck-Status
Rename Pool=Pool umbenennen
Repair corrupted blocks=Repariere beschädigte Blöcke
Replacement disk installed=Ersatzdatenträger installiert
Replacement disk is too small=Ersatzdatenträger zu klein
Retype passphrase=Verschlüsselungspasswort erneut eingeben
Schedule=Planung
Scrub Status=Scrub-Status
Scrub=Scrub
See %s Settings=Bitte %s Einstellungen prüfen
self-test in progress=Selbsttest läuft
Self-Test=Selbsttest
Server boot mode=Server Bootmodus
Set default boot menu=Setze Bootmodus
show passphrase=Zeige Verschlüsselungspasswort
Show=Anzeigen
single=Einfach
Slots=Slots
SMART attribute notifications=SMART-Attribut Benachrichtigungen
SMART controller type=SMART-Controllertyp
SMART error log=SMART-Fehlerprotokoll
SMART extended self-test=SMART erweiterter Selbsttest
SMART health-check failed=SMART Health-Check fehlgeschlagen
SMART notification tolerance level=SMART Benachrichtigungs-Toleranzgrenze
SMART notification value=SMART Benachrichtigungswert
SMART self-test history=SMART Selbsttestverlauf
SMART self-test in progress=SMART Selbsttest läuft
SMART Settings=SMART-Einstellungen
SMART short self-test=SMART Kurz-Selbsttest
SMART status=SMART-Status
Speed=Geschwindigkeit
Spin down delay=Verzögerung beim Herunterfahren
Spin Down=Herunterfahren
Spin Up=Hochfahren
Spinup groups=Datenträger-Gruppen zum Hochfahren
Started, array protected=Gestartet, Array geschützt
Started, array unprotected=Gestartet, Array ungeschützt
Started, clearing=Gestartet, lösche
Started, formatting=Gestartet, formatiere
Starting, copying=Gestartet, kopiere
Starting=Starte
Stopping=Stoppe
Sync errors corrected=Sync-Fehler korrigiert
Sync errors detected=Sync-Fehler erkannt
Sync errors=Sync-Fehler
Sync=Sync
Syslinux Configuration=Syslinux-Konfiguration
Syslinux configuration=Syslinux-Konfiguration
Temp=Temp
The array will be immediately available, but unprotected since parity has not been assigned=Das Array ist sofort verfügbar, aber es bleibt **ungeschützt** da *Parität* nicht zugewiesen wurde
The array will be immediately available, but unprotected until Parity-Sync completes=Das Array ist sofort verfügbar, aber es bleibt **ungeschützt** bis der Paritäts-Synchronisierung fertiggestellt ist
The replacement disk must be as big or bigger than the original=Der Ersatzdatenträger muss mindestens gleich groß wie die Ursprüngliche sein
This is typically done when a new disk is added to the array to get it ready for files to be written to it=Dies geschieht normalerweise, wenn dem Array ein neuer Datenträger hinzugefügt wird, um ihn für das Schreiben von Dateien vorzubereiten
This Unraid OS release has been withdrawn and may no longer be used Please=Diese Unraid OS-Version wurde zurückgezogen und sollte nicht mehr verwendet werden. Bitte
This will ERASE ALL device content=Dies LÖSCHT ALLE Daten am Datenträger
This will ERASE content of ALL devices in the pool=Dies LÖSCHT ALLE Daten auf ALLEN Datenträgern in diesem Pool
This will reboot the system=Startet den Server neu
This will shutdown the system=Fährt den Server herunter
This will stop the array=Stoppt das Array
This will stop the running operation=Stoppt alle laufenden Aufgaben
Threshold=Grenzwert
Title=Titel
To confirm your action type %s=Zum Bestätigen: %s eingeben
Toggle readswrites display=Lese-/Schreibanzeige umschalten
Too many attached devices Please consider upgrading your=Zu viele Datenträger verbunden. Bitte upgrade deine
Too many wrong andor missing disks=Zu viele fehlende/falsche Datenträger
Total size=Gesamtgröße
Unassign ALL devices to delete this pool=Zuweisung **ALLER** Datenträger aufheben um diesen Pool zu löschen
Unassigned Devices=Unassigned Devices
Unavailable - disk must be spun up=Nicht verfügbar - Datenträger müssen hochgefahren sein
unavailable no parity-check entries logged=Nicht verfügbar (keine Paritäts-Prüfeinträge vorhanden)
Unavailable=Nicht verfügbar
Unclean shutdown detected=Unsauberes Herunterfahren erkannt
Unmountable disk present=Nicht einhängbarer Datenträger vorhanden
Unmountable disks present=Nicht einhängbarer Datenträger vorhanden
Unmountable Encrypted volume present=Nicht einhängbares verschlüsseltes Volume vorhanden
Unmountable Missing encryption key=Nicht einhängbar: Fehlender Verschlüsselungsschlüssel
Unmountable No file system=Nicht einhängbar: Kein Dateisystem
Unmountable No pool uuid=Nicht einhängbar: Keine Pool-UUID
Unmountable not btrfs pool=Nicht einhängbar: Kein btrfs-Pool
Unmountable Unsupported or no file system=Nicht einhängbar: Nicht unterstütztes oder kein Dateisystem
Unmountable Volume not encrypted=Nicht einhängbar: Volumen nicht verschlüsselt
Unmounted=Nicht einhängbar
Upgrading diskswapping parity=Aktualisierung Datenträger/Datenträgertausch Parität
Use ASCII characters from space to tilde=Benutze **ASCII** Zeichen von Leerzeichen bis Tilde
Use Default=Benutze Standard
Use default=Benutze Standard
Use only lowercase with no special characters or leadingtrailing digits=Nur Kleinbuchstaben ohne Sonderzeichen oder führende/nachfolgende Ziffern
use printable characters only=nur druckbare Zeichen verwenden
Used=Benutzt
Value=Wert
WARNING canceling may leave the array unprotected=WARNUNG: Beim Abbrechen kann das Array ungeschützt bleiben
Warning disk temperature threshold=Warngrenzwert für Datenträgertemperatur
Warning disk utilization threshold=Warngrenzwert für Datenträgerauslastung
WARNING=WARNUNG
Warranty period=Garantizeitraum
will activate a clean system power down=Löst ein sauberes Herunterfahren aus
will activate a clean system reset=Löst einen sauberen Neustart aus
will bring the array on-line and start Clearing new data disks=Schaltet das Array On-Line und startet das **Löschen** neuer Datenträger
will bring the array on-line and start Data-Rebuild=Schaltet das Array On-Line und startet die Datenwiederherstellung
will bring the array on-line and start Disk-Clear of new data disks=Schaltet das Array On-Line und startet den Datenträgerlöschung für neue Datenträger
will bring the array on-line and start Parity-Check=Schaltet das Array On-Line und startet die **Paritätsprüfung**
will bring the array on-line and start Parity-Sync andor Data-Rebuild=Schaltet das Array On-Line und startet den **Paritäts-Synchronisierung** und/oder die **Datenwiederherstellung**
will bring the array on-line and start Parity-Sync=Schaltet das Array On-Line und startet die Paritätssynchronisierung
will bring the array on-line=Schaltet das Array On-Line
will copy the parity information to the new parity disk=Kopiert die Paritäts-Informationen auf den neuen Paritätsdatenträger
will create a file system in all Unmountable disks=Erstellt ein neues Dateisystem auf allen nicht einhängbaren Datenträgern
will delete the encryption keyfile=Löscht den Verschlüsselungsschlüssel
will disable the missing disk and then bring the array on-line Install a replacement disk as soon as possible=Deaktiviert den fehlende Datenträger und schaltet das Array On-Line. Datenträger so schnell als möglich ersetzen
will expand the file system of the data disk if possible then bring the array on-line and start Data-Rebuild=Erweitert das Dateisystem des Datenträgers wenn möglich; schaltet danach das Array On-Line und startet Datenwiederherstellung
will immediately clear all disk statistics=Löscht alle Datenträgerstatistiken
will immediately invoke the Mover=Startet den Mover manuell
will immediately spin down all disks=Fährt alle Datenträger herunter
will immediately spin up all disks=Fährt alle Datenträger hoch
will pause Data-Rebuild=pausiert Datenwiederherstellung
will pause Disk-Clear=Pausiert Datenträgerlöschung
will pause Parity-Check=Pausiert Paritätprüfung
will pause Parity-Sync=Pausiert Paritäts-Synchronisierung
will pause Read-Check=Pausiert Leseprüfung
will pause the Clearing=Pausiert den Löschvorgang
will pause the Parity-Check=Pausiert die Paritätsprüfung
will pause the Parity-SyncData-Rebuild=Pausierte Paritäts-Synchronisierung/Datenwiederherstellung
will pause the Read-Check=Pausiert die Leseprüfung
will record all disk information and bring the array on-line=Speichert alle Datenträgerinformationen und schaltet das Array On-Line
will record all disk information, bring the array on-line, and start Parity-Sync=speichert alle Datenträgerinformationen, schaltet das Array On-Line und startet Paritäts-Synchronisierung
will remove the missing cache disk and then bring the array on-line=Entfernt den fehlenden Cache Datenträger und schaltet das Array On-Line
will resume Data-Rebuild=Setzt die Datenwiederherstellung fort
will resume Disk-Clear=Setzt die Datenträgerlöschung fort
will resume Parity-Check=Setzt die Paritätsprüfung fort
will resume Parity-Sync=Setzt die Paritäts-Synchronisierung fort
will resume Read-Check=Setzt die Leseprüfung fort
will resume the paused Clearing=Setzt die pausierte Löschung fort
will resume the paused Parity-Check=Setzt die pausierte Pariätsprüfung fort
will resume the paused Parity-SyncData-Rebuild=Setzt die pausierte Paritäts-Synchronisierung/Datenwiederherstellung fort
will resume the paused Read-Check=Setzt die pausierte Leseprüfung fort
will start Clearing new data disks=Startet **Löschvorgang** von neuen Datenträgern
will start Data-Rebuild=Startet **Datenwiederherstellung**
will start Disk-Clear of new data disks=Startet **Datenträgerlöschung** von neuen Datenträger(n)
will start Parity-Check=Startet **Paritätsprüfung**
will start Parity-Sync andor Data-Rebuild=Startet **Paritäts-Synchronisierung** und/oder **Datenwiederherstellung**
will start Parity-Sync=Startet **Paritäts-Synchronisierung**
will start Read-Check of all array disks=Startet **Leseprüfung** von allen Array-Datenträgern
will stop Clearing=Stoppt Löschvorgang
will stop Data-Rebuild=Stoppt Datenwiederherstellung
will stop Disk-Clear=Stoppt Datenträgerlöschung
will stop Parity-Check=Stoppt Paritätsprüfung
will stop Parity-Sync=Stoppt Paritäts-Synchronisierung
will stop Parity-SyncData-Rebuild=Stoppt die Paritäts-Synchronisierung/Datenwiederherstellung
will stop Read-Check=Stoppt Leseprüfung
will stop the Parity-Check=Stoppt die Paritätsprüfung
will stop the Read-Check=Stoppt die Leseprüfung
will take the array off-line=Schaltet das Array Off-Line
Worst=Schlechtester
Write corrections to parity=Schreibe Paritätskorrekturen
Writes=Geschrieben
Wrong key=Falscher Schlüssel
Wrong Pool State=Falscher Pool
xfs_repair status=xfs_repair-Status
You may not add new disks and also remove existing disks=Es ist nicht möglich, neue Festplatten hinzuzufügen und gleichzeitig bestehende Festplatten zu entfernen
your server=Dein Server
zfs pool status=ZFS-Poolstatus
zfs=ZFS

; Sleep plugin translations
Check this=Hier
for more information=findest du weitere Informationen
Make sure your server supports S3 sleep=Stelle sicher, dass dein Server den S3-Ruhezustand unterstützt
Sleep will immediately put the server in sleep mode=**Ruhezustand** versetzt den Server sofort in den Ruhezustand
Sleeping=Schläft
System in sleep mode=System im Ruhezustand
This will put the system in sleep mode=Dadurch wird das System in den Ruhezustand versetzt
wiki entry=Wiki-Eintrag

; Note: April 29, 2023 - 1 missing translations
If this is a new array, move the largest disk into the parity slot=Falls es sich um ein neues Array handelt, benutze den größten Datenträger für den *Parität-Slot*.
