Add Share=Freigabe hinzufügen
All files encrypted=Alle Dateien verschlüsselt
All files protected=Alle Dateien geschützt
All files unprotected=Alle Dateien ungeschützt
Allocation method=Verteilungsmethode
Array must be Started to view Shares=Das Array muss **gestartet** sein, um die Freigaben zu sehen
Automatically split any directory as required=Jedes Verzeichnis automatisch nach Bedarf aufteilen
Automatically split only the top five directory levels as required=Nur die obersten fünf Verzeichnisse nach Bedarf aufteilen
Automatically split only the top four directory levels as required=Nur die obersten vier Verzeichnisse nach Bedarf aufteilen
Automatically split only the top level directory as required=Nur die oberste Verzeichnis-Ebene nach Bedarf aufteilen
Automatically split only the top three directory levels as required=Nur die obersten drei Verzeichnisse nach Bedarf aufteilen
Automatically split only the top two directory levels as required=Nur die obersten zwei Verzeichnisse nach Bedarf aufteilen
Calculated free space value=
Comments=Kommentare
Compute All=Alles berechnen
Compute=Berechnen
Disk Shares=Datenträger Freigaben
Do not use pool names=Verwenden Sie keine Pool Namen
Do not use reserved names=Verwenden Sie keine reservierten Namen
Enable Copy-on-write=Copy-on-Write aktivieren
Enter a name for the share=Geben Sie einen Namen für die Freigabe ein
Excluded disks=Exkuldierte Datenträger
Exclusive access=
Export=Exportieren
Fill-up=Auffüllen
Free=Frei
has been deleted=wurde gelöscht
HDD=HDD
High-water=Hochwasser
Included disks=Einbezogene Datenträger
Invalid Characters=Ungültige Zeichen
Invalid share name=Ungültiger Freigabename
Manual do not automatically split directories=Manuell: Verzeichnisse werden nicht aufgeteilt
Minimum free space=Minimaler freier Speicherplatz
Missing share name=Fehlender Freigabename
Most-free=Am meisten frei
Mover action=
Mover takes no action=Mover wird nicht aktiviert
Mover transfers files from array to cache=Der Mover verschiebt Dateien vom Array zum Cache
Mover transfers files from cache to array=Der Mover verschiebt Dateien vom Cache zum Array
Mover transfers files from Primary storage to Secondary storage=
Mover transfers files from Secondary storage to Primary storage=
next user share=Nächste Benutzerfreigabe
Not used=
Only=Nur
Prefer=Bevorzugt
previous user share=Vorherige Benutzerfreigabe
Primary storage for new files and folders=Primary storage (for new files and folders)
Read=Lesen
Recompute=Neu berechnen
Rule=Regel
Secondary storage=
Select cache pool=Cache-Pool auswählen
Set when adding new share only=Nur beim Hinzufügen einer neuer Freigabe festlegen
Share contains data=Freigabe enthält Daten
Share is empty=Freigabe ist leer
Share is outside the list of designated disks=Freigabe gehört nicht zur Liste der dafür ausgewählten Datenträger
Share Settings=Freigabeeinstellungen
Share status=Freigabestatus
Size=Größe
Some or all files unencrypted=Einige oder alle Dateien sind unverschlüsselt
Some or all files unprotected=Einige oder alle Dateien sind ungeschützt
Split level=Aufteilungs-Niveau
SSD=SSD
Storage=
There are no exportable disk shares=Es existieren keine zu exportierenden Datenträgerfreigaben
There are no exportable user shares=Es existieren keine zu exportierenden Benutzerfreigaben
Time Machine volume size limit=Time Machine Volumengröße
Unknown encryption state=Unbekannter Verschlüsselungsstatus
Use cache pool for new filesdirectories=Benutze den Cache-Pool (für neue Dateien/Verzeichnisse)
User Shares=Benutzerfreigaben
Write=Schreiben
You cannot use the following within share names=Du kannst folgendes nicht im Freigabenamen verwenden

; Note: April 18, 2023 - 8 missing translations
